#-------------------------------------------------------------
# Syntax Coloring Map
# Words separated by TAB, not SPACE
#-------------------------------------------------------------


#-------------------------------------------------------------
# KEYWORD1 - Classes
#-------------------------------------------------------------

IRdecodeBase	KEYWORD1
IRdecodeTamiya	KEYWORD1
IRdecodeTamiya_2Shot	KEYWORD1
IRdecodeTamiya35	KEYWORD1
IRdecodeHengLong	KEYWORD1
IRdecodeTaigen	KEYWORD1
IRdecodeFOV	KEYWORD1
IRdecodeVsTank	KEYWORD1
IRdecodeWalterson72	KEYWORD1
IRdecodeOpenPanzer	KEYWORD1
IRdecodeClark_Repair	KEYWORD1
IRdecodeIBU_Repair	KEYWORD1
IRdecodeRCTA_Repair	KEYWORD1
IRdecodeClark_MG	KEYWORD1
IRdecodeRCTA_MG	KEYWORD1
IRdecodeSony	KEYWORD1
IRdecode	KEYWORD1

IRsendBase	KEYWORD1
IRsendTamiya	KEYWORD1
IRsendTamiya_2Shot	KEYWORD1
IRsendTamiya35	KEYWORD1
IRsendHengLong	KEYWORD1
IRsendTaigen	KEYWORD1
IRsendFOV	KEYWORD1
IRsendVsTank	KEYWORD1
IRsendWalterson72	KEYWORD1
IRsendOpenPanzer	KEYWORD1
IRsendClark_Repair	KEYWORD1
IRsendIBU_Repair	KEYWORD1
IRsendRCTA_Repair	KEYWORD1
IRsendClark_MG	KEYWORD1
IRsendRCTA_MG	KEYWORD1
IRsendSony	KEYWORD1
IRsendRaw	KEYWORD1

IRrecvBase	KEYWORD1
IRrecvPCI	KEYWORD1


#-------------------------------------------------------------
# KEYWORD2 - Methods, functions, members
#-------------------------------------------------------------
ReverseByte	KEYWORD2
IRTYPES		KEYWORD2
IRTEAMS		KEYWORD2
decode	KEYWORD2
decode_type	KEYWORD2
value	KEYWORD2
bits	KEYWORD2
rawbuf	KEYWORD2
rawlen	KEYWORD2
IgnoreHeader	KEYWORD2
Reset	KEYWORD2
decodeGeneric	KEYWORD2
DumpResults	KEYWORD2
UseExtnBuf	KEYWORD2
copyBuf	KEYWORD2
convertValueToSonyNumbers	KEYWORD2
SonyDeviceID	KEYWORD2
SonyCommand	KEYWORD2
sendGeneric	KEYWORD2
send	KEYWORD2
sendTeam2	KEYWORD2
sendTeam3	KEYWORD2
sendTeam4	KEYWORD2
sendTeamA	KEYWORD2
sendTeamB	KEYWORD2
sendDeviceIDCommand	KEYWORD2
No_Output	KEYWORD2
setBlinkingOnReceive	KEYWORD2
GetResults	KEYWORD2
enableIRIn	KEYWORD2
resume	KEYWORD2
getPinNum	KEYWORD2
Mark_Excess	KEYWORD2
Pin_from_Intr	KEYWORD2
PERCENT_LOW	KEYWORD2
PERCENT_HIGH	KEYWORD2
ABS_MATCH	KEYWORD2
PERC_MATCH	KEYWORD2
MATCH	KEYWORD2
MATCH_MARK	KEYWORD2
MATCH_SPACE	KEYWORD2


#-------------------------------------------------------------
# LITERAL1 - Constants & Defines
#-------------------------------------------------------------

IR_UNKNOWN	LITERAL1
IR_DISABLED	LITERAL1
IR_TAMIYA	LITERAL1
IR_TAMIYA_2SHOT	LITERAL1
IR_TAMIYA_35	LITERAL1
IR_HENGLONG	LITERAL1
IR_TAIGEN	LITERAL1
IR_WALTERSON_72	LITERAL1
IR_FOV	LITERAL1
IR_VSTANK	LITERAL1
IR_OPENPANZER	LITERAL1
IR_RPR_CLARK	LITERAL1
IR_RPR_IBU	LITERAL1
IR_RPR_RCTA	LITERAL1
IR_MG_CLARK	LITERAL1
IR_MG_RCTA	LITERAL1
IR_SONY	LITERAL1
IR_TEAM_NONE	LITERAL1
IR_TEAM_FOV_2	LITERAL1
IR_TEAM_FOV_3	LITERAL1
IR_TEAM_FOV_4	LITERAL1
IR_TEAM_WALTERSON72_A	LITERAL1
IR_TEAM_WALTERSON72_B	LITERAL1
Tamiya_BITS	LITERAL1
Tamiya_GAP	LITERAL1
Tamiya_TIMESTOSEND	LITERAL1
Taigen_MARK	LITERAL1
Taigen_SPACE	LITERAL1
Taigen_BITS	LITERAL1
HengLong_HDR_MARK	LITERAL1
HengLong_SHORT_BIT	LITERAL1
HengLong_LONG_BIT	LITERAL1
HengLong_GAP	LITERAL1
HengLong_BITS	LITERAL1
HengLong_TIMESTOSEND	LITERAL1
FOV_HDR_MARK	LITERAL1
FOV_SPACE	LITERAL1
FOV_ONE_MARK	LITERAL1
FOV_ZERO_MARK	LITERAL1
FOV_GAP	LITERAL1
FOV_BITS	LITERAL1
FOV_TIMESTOSEND	LITERAL1
FOV_TEAM_1_VALUE	LITERAL1
FOV_TEAM_2_VALUE	LITERAL1
FOV_TEAM_3_VALUE	LITERAL1
FOV_TEAM_4_VALUE	LITERAL1
VsTank_HDR_MARK	LITERAL1
VsTank_SPACE_SHORT	LITERAL1
VsTank_SPACE_LONG	LITERAL1
VsTank_ONE_MARK	LITERAL1
VsTank_ZERO_MARK	LITERAL1
VsTank_BITS	LITERAL1
VsTank_TIMESTOSEND	LITERAL1
WALTERSON72_TEAM_A_VALUE	LITERAL1
WALTERSON72_TEAM_B_VALUE	LITERAL1
Clark_REPAIR_CODE	LITERAL1
Clark_REPAIR_TIMESTOSEND	LITERAL1
Clark_REPAIR_GAP	LITERAL1
Clark_MG_CODE	LITERAL1
Clark_MG_GAP	LITERAL1
RCTA_BITS	LITERAL1
RCTA_REPAIR_TIMESTOSEND	LITERAL1
MAX_SONY_DEVICE_ID	LITERAL1
MAX_SONY_COMMAND	LITERAL1
MG_REPEAT_TIME_mS	LITERAL1
GAP	LITERAL1
MARK_EXCESS_DEFAULT	LITERAL1
OP_IRLib_USE_PERCENT	LITERAL1
USECPERTICK	LITERAL1
PERCENT_TOLERANCE	LITERAL1
DEFAULT_ABS_TOLERANCE	LITERAL1

